00000002112000000211
00000002112000000211
00000002112000000211
00000002112000000211
11111111110111111111
11111111111111111111
11111111111111111111
11111111111111111111
11111111111111111111
11111111111111111111
